0000000000000000000000000000000000000000000000000000000000000000000000000000000000
0000000000000000000000000000000000000000000000000000000000000000000000000000000000
0000000000000000000000000000000000000000000000000000000000000000000000000000000000
0000000022200000000000000000000000000000000000000000000000000000000222000000000000
0000000211120000000000000000000000000222220000000000000000000000000011000000000000
0000000000000000000000000000000000000000000000000000000000000000000000000000000000
0000000000000000000000000000000000000000000000000000000000002222200001000000000000
2200000000000000022000000220002200000000000000022000000220000111200000000000000000
1122222222222222211000022112001122222222222222211000022112000011000020000000000000
1111111111111111111000011111001111111111111111111000011111000010000000002222000000
1111111111111111111000001100001111111111111111111000001100000000022000000000000000
1111111111111111111000001000001111111111111111111000001000000000000000000000000000
1111111111111111111000001000001111111111111111100000001000000000000022200000000000
1111111111111111111000000000001111111111111111100000000000000000000011120000000000
0011111111111111100000000000000111111111100111000000000000000000000011000000000000
0000110000111111000000000000000000000011000000000000000000000000000001000000000000
0000010000000111000000000000000000000001000000000000000000000000000000000022200000
0000010000000000000000000000000000000000000000000000000000000000000000000001100000
0000000000000000000000000000000000000000000000000000000000000000000000000000000000
0000000000000000000000000000000000000000000000000000000000000000000000000000000000
0000000000000000000000000000000000000000000000000000000000000000000000000000000000
0000000000000000000000000000000000000000000000000000000000000000000000000000000000
0000000000000000000000000000000000000000000000000000000000000000000000000000000000
0000000000000000000000000000000000000000000000000000000000000000000000000000000000
0000000000000000000000000000000000000000000000000000000000000000000000000000000000
0000000000000000000000000000000000000000000000000000000000000000000000000002220000
0000000000000000000000000000000000000000000000000000000000000000002222200000110000
0000000000000000000000000000000000000000000000000000000000000000000111000000100000
0000000000000000000000000000000000000000000000000000000000000000000001000000000000