000000000000000000000000000000000000000000000000000000000000
000000000000000000000000000000000000000000000002000000000000
000000000000000000000000000000000000000000000000000000000000
000000000000000000000000000000000000000000220000000000000000
000000000000000000000000000000000002220000000000000000000000
000000000000000000000000000000000000000000000000000000000000
220000000000000002200000022000000000000000000000000000023000
222202220002222222200002222200222222222222222000000002222200
222202220002222222200002222200222222222222222000000002222200
222202220002222222200000220000222222222222222000000000220000
222202220002222222200000200000222222222222222000000000200000
222202220002222222200000200000222222222222222000000000200000
222202220002222222200000000000222222222222222000000000000000