0000000000000000000000000000000000000000000000000000000000000000000000000000000000
0000000000000000000000000000000000000000000000010000000000000000000000000000000000
0000000000000000000000000000000000000000000000000000000000000000000000000000000000
0000000000000000000000000000000000000000002220000000000000000000000000000000000000
0000000000000000000000000000000000022200000000000001000000000222200000000000000000
0000000000000000000000000000000000000000000000000000000000000011000000000000000000
2200000000000000022000000110000000000000000000000000000200000001000000000000000000
1122022200022222211000011111022222222222222222220000022122000000000000000000000000
1111011100011111111000011111000111111110011111100000011111000000000000000000000000
1111011100011111111000001100000111111100001111000000001100000000000000000000000000
1111011100011111111000001000000011111122201110000000001000000000000000000000000000
1110010100011111111000001000000011100011121110000000001000000000000000000000000000
1100000100011111111000000000000010000000111110000000000000000000000000000000000000
0000000000001111111000000000000000000000001110000000000000000000000022220000000000
0000000000000100011000000000000000000000000100000000000000000000000001112000000000
0000000000000000000000000000000000000000000000000000000000000000000000110000000000
0000000000000000000000000000000000000000000000000000000000000000000000100000000000
0000000000000000000000000000000000000000000000000000000000000000000000000000000000